.#........
.######...
..##.##...
......C...
......#...
......#...
.....##...
....###...
......C...
......#...